0,0,1,0,0,0,0,0,0,0
1,1,1,0,0,5,5,-1,6,0
0,1,1,1,-1,5,0,0,6,0
0,0,1,1,0,5,0,6,6,0
0,2,2,0,0,-1,0,0,6,6
3,2,2,0,0,7,7,0,6,6
3,0,4,4,-1,7,7,7,7,0
3,3,4,4,0,0,7,7,0,8
3,0,4,4,4,0,0,8,8,8
0,0,0,4,0,0,0,0,8,0